111111111111111111
133333333333333331
131111113111111131
141111113111111131
131111113111111131
133333333333333333
131111113111311111
131111113111311111
133333333111333333
111111113111111101
111111113111111101
111111113111000000
111111113111011112
111111113111011100
000000003000011505
111111113111011111
111111113111011111
111111113111000000
111111113111011111
111111113111011111
133333333333333331
131111113111111131
131111113111111131
143331113333333333
111131113111311111
111131113111311111
133333333111333331
131111111111111131
131111111111111131
133333333333333333
111111111111111111