1111111111111111111
1333333333333333311
1311111131111111311
1411111131111111311
1311111131111111311
1333333333333333333
1311111131113111111
1311111131113111111
1333333331113333333
1111111131111111311
1111111131111111311
1111111131113333333
1111111131113111122
1111111131113111000
0000000033333113a3a
1111111131113111111
1111111131113111111
1111111131113333333
1111111131113111111
1111111131113111111
1333333333333333311
1311111131111111311
1311111131111111311
1433311133333333333
1111311131113111111
1111311131113111111
1333333331113333311
1311111111111111311
1311111111111111311
1333333333333333333
1111111111111111111